XXXXXXXXXXXXXXXXXXXXXXXXXXXX
XppppppppppppppppppppppppppX
XpXXpXXXXpXXXXXXXXpXXXXpXXpX
XPXXpXXXXpXXXXXXXXpXXXXpXXPX
XpXXpXXXXpXXppppXXpXXXXpXXpX
XpXXppppppXXpXXpXXppppppXXpX
XpXXXXpXXpXXpXXpXXpXXpXXXXpX
XpXXXXpXXpXXpXXpXXpXXpXXXXpX
XppppppXXppppXXppppXXppppppX
XXXpXXXXXXXX_XX_XXXXXXXXpXXX
XXXpXXXXXXXX_XX_XXXXXXXXpXXX
XXXppppXX__________XXppppXXX
XXX_XXpXX_XXXXXXXX_XXpXX_XXX
T___XXpXX_X______X_XXpXX___T
XXXXXXp___X______X___pXXXXXX
XXXXXXpXX_X______X_XXpXXXXXX
T___XXpXX_XXXXXXXX_XXpXX___T
XXX_XXpXX__________XXpXX_XXX
XXXppppXXXXX_XX_XXXXXppppXXX
XXXpXXpXXXXX_XX_XXXXXpXXpXXX
XXXpXXpppp___XX___ppppXXpXXX
XXXpXXXXXpXX_XX_XXpXXXXXpXXX
XXXpXXXXXpXX_XX_XXpXXXXXpXXX
XpppppppppXX____XXpppppppppX
XpXXXXpXXpXXXXXXXXpXXpXXXXpX
XpXXXXpXXpXXXXXXXXpXXpXXXXpX
XpXXpppXXppppppppppXXpppXXpX
XPXXpXXXXXXXpXXpXXXXXXXpXXPX
XpXXpXXXXXXXpXXpXXXXXXXpXXpX
XppppppppppppXXppppppppppppX
XXXXXXXXXXXXXXXXXXXXXXXXXXXX