XXXXXXXXXXXXXXXXXXXXXXXXXXXX
XppppppXXppppppppppXXppppppX
XPXXXXpXXpXXXXXXXXpXXpXXXXPX
XpXXXXpXXpXXXXXXXXpXXpXXXXpX
XppppppppppppppppppppppppppX
XXXpXXpXXXXXpXXpXXXXXpXXpXXX
XXXpXXpXXXXXpXXpXXXXXpXXpXXX
XXXpXXpXXXXXpXXpXXXXXpXXpXXX
T__pXXpppppppXXpppppppXXp__T
XXXpXXXXX_XXXXXXXX_XXXXXpXXX
XXXpXXXXX_XXXXXXXX_XXXXXpXXX
XXXp____________________pXXX
XXXpXXXXX_XXXXXXXX_XXXXXpXXX
XXXpXXXXX_X______X_XXXXXpXXX
XXXpXX____X______X____XXpXXX
XXXpXX_XX_X______X_XX_XXpXXX
XXXpXX_XX_XXXXXXXX_XX_XXpXXX
T__p___XX__________XX___p__T
XXXpXXXXXXXX_XX_XXXXXXXXpXXX
XXXpXXXXXXXX_XX_XXXXXXXXpXXX
XXXppppppp___XX___pppppppXXX
XXXpXXXXXpXXXXXXXXpXXXXXpXXX
XXXpXXXXXpXXXXXXXXpXXXXXpXXX
Xpppppppppppp__ppppppppppppX
XpXXXXpXXXXXpXXpXXXXXpXXXXpX
XpXXXXpXXXXXpXXpXXXXXpXXXXpX
XpXXXXpXXppppXXppppXXpXXXXpX
XPXXXXpXXpXXXXXXXXpXXpXXXXPX
XpXXXXpXXpXXXXXXXXpXXpXXXXpX
XppppppppppppppppppppppppppX
XXXXXXXXXXXXXXXXXXXXXXXXXXXX