XXXXXXXXXXXXXXXXXXXXXXXXXXXX
T______XXppppppppppXX______T
XXXXXX_XXpXXXXXXXXpXX_XXXXXX
XXXXXX_XXpXXXXXXXXpXX_XXXXXX
XPpppppppppppXXpppppppppppPX
XpXXXXXXXpXXpXXpXXpXXXXXXXpX
XpXXXXXXXpXXpXXpXXpXXXXXXXpX
XpXXppppppXXpXXpXXppppppXXpX
XpXXpXXXX_XXppppXX_XXXXpXXpX
XpXXpXXXX_XXXXXXXX_XXXXpXXpX
XppppppXX_XXXXXXXX_XXppppppX
XXXXXXpXX__________XXpXXXXXX
XXXXXXpXX_XXXXXXXX_XXpXXXXXX
XppppppXX_X______X_XXppppppX
XpXXXXpXX_X______X_XXpXXXXpX
XpXXXXp___X______X___pXXXXpX
XpppXXpXX_XXXXXXXX_XXpXXpppX
XXXpXXpXX__________XXpXXpXXX
XXXpXXpXXXX_XXXX_XXXXpXXpXXX
XXXpXXpXXXX_XXXX_XXXXpXXpXXX
XXXpppppppppXXXXpppppppppXXX
XXXpXXXXXXXpXXXXpXXXXXXXpXXX
XXXpXXXXXXXpXXXXpXXXXXXXpXXX
T__ppppXXppp____pppXXpppp__T
XXXpXXpXXpXXXXXXXXpXXpXXpXXX
XXXpXXpXXpXXXXXXXXpXXpXXpXXX
XPppXXpppppppXXpppppppXXppPX
XpXXXXpXXXXXpXXpXXXXXpXXXXpX
XpXXXXpXXXXXpXXpXXXXXpXXXXpX
XppppppppppppppppppppppppppX
XXXXXXXXXXXXXXXXXXXXXXXXXXXX