XXXXXXXXXXXXXXXXXXXXXXXXXXXX
XpppppppppXXppppXXpppppppppX
XpXXXXXXXpXXpXXpXXpXXXXXXXpX
XPXXXXXXXpXXpXXpXXpXXXXXXXPX
XpXXpppppppppXXpppppppppXXpX
XpXXpXXpXXXXpXXpXXXXpXXpXXpX
XppppXXpXXXXpXXpXXXXpXXppppX
XXXXpXXpXXXXpXXpXXXXpXXpXXXX
XXXXpXXppppppppppppppXXpXXXX
TppppXXXX_XXXXXXXX_XXXXppppT
XpXX_XXXX_XXXXXXXX_XXXX_XXpX
XpXX____________________XXpX
XpXXXX_XX_XXXXXXXX_XX_XXXXpX
XpXXXX_XX_X______X_XX_XXXXpX
Xp_____XX_X______X_XX_____pX
XpXX_XXXX_X______X_XXXX_XXpX
XpXX_XXXX_XXXXXXXX_XXXX_XXpX
XpXX____________________XXpX
XpXXXX_XXXXX_XX_XXXXX_XXXXpX
XpXXXX_XXXXX_XX_XXXXX_XXXXpX
XppppppXXppppXXppppXXppppppX
XXXpXXpXXpXXXXXXXXpXXpXXpXXX
XXXpXXpXXpXXXXXXXXpXXpXXpXXX
XPppXXppppppp__pppppppXXppPX
XpXXXXpXXXXXpXXpXXXXXpXXXXpX
XpXXXXpXXXXXpXXpXXXXXpXXXXpX
XppppppXXppppXXppppXXppppppX
XpXXXXpXXpXXXXXXXXpXXpXXXXpX
XpXXXXpXXpXXXXXXXXpXXpXXXXpX
XppppppXXppppppppppXXppppppX
XXXXXXXXXXXXXXXXXXXXXXXXXXXX